12 40
BBBBBBBBBBBBBBBBBBBBBBBBBBBBBBBBBBBBBBBB
B                                B     B
B                                B     B
B                                B     B
B              B   B             B     B
B              BB BB          BBBB     B
B              BB BB             B     B
BBB                              B     B
B              BB                BB    B
B                                      B
B    B         BB         BB           B
BBBBBBBBBBBBBBBBBBBBBBBBBBBBBBBBBBBBBBBB
2
300 300 Player
600 600 Elf_Minion