15 28
ABCBCBCBCBCBCBCBCBCBCBCBCBCD
E                          F
G                          H
E                          F
G                          H
E                          F
G                          H
E                          F
G                          H
E                          F
G                          H
E                          F
G                          H
-                          -
I-KJKJKJKJKJKJKJKJKJKJKJKJ-L