12 40
BBBBBBBBBBBBBBBBBBBBBBBBBBBBBBBBBBBBBBBB
B                                B     B
B                                B     B
B                                B     B
B              BBBBB             B     B
B              BBBBB          BBBB     B
B              BBBBB             B     B
BBB                              B     B
B              BB                BB    B
B              BB                      B
B    B         BB         BB           B
BBBBBBBBBBBBBBBBBBBBBBBBBBBBBBBBBBBBBBBB
2
300 300 Player
600 600 Elf_Minion
420 300 Player