12 40
BBBBBBBBBBBBBBBBBBBBBBBBBBBBBBBBBBBBBBBB
B                     00         B     B
B                 0000           B     B
B                                B     B
B                                B     B
B         0000                BBBB     B
B                                B     B
BBB                              B     B
B              BB                BB    B
B              BB                      B
B    B         BB         BB           B
BBBBBBBBBBBBBBBBBBBBBBBBBBBBBBBBBBBBBBBB